/-\/-\/-\/-\/-\/-\
|*  *  *  *  *  *|
\-/\- \- \-/\- \ /
/-\/-\ -\ -\/-\  \
|*||*  *  *  *||*|
\  \- \-/\-/\- \-/
/ \ -\ -\/-\/-\ -\
|*  *  *||*  *  *|
\- \- \- \- \- \ /
/-\ -\ -\ -\ -\  \
|*||*||*  *  *||*|
\ /\- \-/\-/\- \-/
/ \/-\ -\/-\/-\ -\
|*  *  *||*||*  *|
\  \- \-/ -  - \ /
/ \ -\ - /-  -\  \
|*||*  *||*  *||*|
\-/\-/\-/\-/\-/\-/